11111111111111111111111111111111
10000000000001000000000000000001
10000000000001000000000000000001
10020000000001000000000000000001
10000000000001000000000000000001
10000000000001000000000000000001
10000000000001000000000000000001
10000000000001000000000000000001
10000000000001000000000000000001
10000000000001000000000000000001
10000000000001000000000000000001
10000000000001000000000000000001
10000000000000000000000000000001
10000000000000000000300000000001
10000000000001000000000000000001
10000000000001000000000000000001
10000000000001000000000000000001
11111111111111111111111111111111
