11111111111111111111111111111111
10000000000000100000000000000001
10000000000000100000000000000001
10020000000000100000000000000001
10000000000000100000000000000001
10000000000000100000000000000001
10000000000000100000000000000001
10000000000000100000000000000001
10000000000000100000000000000001
10000000000000100000000000000001
10000000000000100000000000000001
10000000000000111111111110000001
10000000000000001000000010000001
10000000000011001000300010000001
10000000000011111000000010000001
10000000000011111000000010000001
10000000000000000000000010000001
11111111111111111111111111111111
