00000000000000000100000000000000
00000000000000001100000000000000
00000000000000001000000000000000
00020000000000001000000000000000
00000000000000001000000000000000
00000000000000011000000000000000
00000100111111110000000000000000
00000100100000000000000000000000
00000100100000000000000000000000
00000100100000000000000000000000
00000100100000000000000000000000
00000100111111111000000000000000
00000100000000000000000000000000
00111100000000000000300000000000
11000000000000000000000000000000
10000000000000000000000000000000
10000000000000000000000000000000
10000000000000000000000000000000
