11111111111111111111111111111111
10000000000000000100000000000001
10000000000000000100000000000001
10020000000000000100000000000001
10000000000000000100000000000001
10000000000000000100000000000001
10000000000000000100000000000001
10000000000000000100000000000001
10000000000000000110000000000001
10000000000000000010000000000001
10000000000000000010000000000001
10000000000000000010000000000001
10000000000000000010000000000001
10000000000000000010300000000001
10000000000000000010000000000001
10000000000000000010000000000001
10000000000000000000000000000001
11111111111111111111111111111111
