00000000000000000100000000000000
00000000000000000100000000000000
00000000001000000100000000000000
00020000001000000100000000000000
00000000001000001100000000000000
00000000001000001000000000000000
00000000001000001000000000000000
00000000001001111000000000000000
00000000001110000000000000000000
00000111111100000000000000000000
00000000001000000000000000000000
00000000001000000000000000000000
00000000000000000000000000000000
00000000000010000000300000000000
00000000000010000000000000000000
01111111111111100000000000000000
11000000000000011111110000000000
00000000000000000000000000000000
